##############
#P...........#
#............#
#............#
#............#
##############
